##########
#>.....###
#>.....###
#.......##
#####....#
####.....#
##......##
#**...####
#**...####
##########