##############################
##############################
##**************************##
##**************************##
##.###########################
##.###########################
##..........................##
##..........................##
##..........................##
############.#################
############.#################
###.........................##
###.........................##
###.........................##
###.........................##
###.........................##
###.##########################
###........##############...##
###.........############...###
###..........##########...####
###...........########...#####
###............######...######
###....................#######
###...................########
###..................#########
################.#############
##>>>>>>>>>>>>>>>>>>>>>>>>>>##
##>>>>>>>>>>>>>>>>>>>>>>>>>>##
##############################
##############################